11111
10201
12001
10341
13001
11111
