00111100
11102111
14020501
10493051
11130111
00111100
