11111
10201
12001
19301
13001
11111
